1111111111111111111111111111111111111111111111111111111111
1111111111111111111111111111111111111111111111111111111111
1111111111111111111111111111111111111111111111111111111111
1111111111111111111111111111111111111111111111111111111111
1111111111111111111111111100000000000000000000000000111111
1111111111111111111111111102222222222222222222222220111111
1111111111111111111111111102222222222222223333333320111111
1111111111111111111111111102222222222222223333333320111111
1111111111111111111111111102222222222222223333333320111111
1111111111111111111111111102222222222222222222222220111111
1111111111111111111111111102222222222222222222222220111111
1111111111111111111111111102222222222222222222222220111111
1111111111111111111111111102222222222222222222222220111111
1111111111111111111111111102222222222222222222222220111111
1111111111111111111111111102222222222222222222222220111111
1111111111111111111111111102200000000000000000000000111111
1111111111111111111111111102201111111111111111111111111111
1111100000000000000000000002201111111111111111111111111111
1111102222222222222222222222201111111111111111111111111111
1111102222222222222222222222201111111111111111111111111111
1111102222222222222222222200001111111111111111111111111111
1111102222222222222222222201111111111111111111111111111111
1111102222222222222222222201111111111111111111111111111111
1111102222222222222222222201111111111111111111111111111111
1111102222222222222222222201111111111111111111111111111111
1111102222222222222222222201111111111111111111111111111111
1111102222222222222222222201111111111111111111111111111111
1111102222222222223333332201111111111111111111111111111111
1111102222222222223333332201111111111111111111111111111111
1111102222222222223333332201111111111111111111111111111111
1111102222222222222222222201111111111111111111111111111111
1111100000000000000000000001111111111111111111111111111111
1111111111111111111111111111111111111111111111111111111111
1111111111111111111111111111111111111111111111111111111111
1111111111111111111111111111111111111111111111111111111111
1111111111111111111111111111111111111111111111111111111111
